000000010000000
000000010000000
000000010000000
000100000000000
000100000000001
000000000000001
000000000010000
000000000010000
111100000100000
100000000100000
100000000000000
000000000000000
000000000000000
000000000000111
000001000000000
000111000000000
000000000000000
000000000011000
000000000011000
000000000011000
