000001000000000
000000000000000
000000000000000
000000000100000
000111000000000
000000000001000
000000000001000
000000000001000
000000000001000
000100000001000
000100000001000
000100000000000
000100000000000
000100000000000
000100000000000
000000000111000
000001000000000
000000000000000
000000000000000
000000000100000