000000000000000
010000000000000
000000000000000
111100001100000
000100001100000
000000000000000
000000000000000
000000000000000
000100000001111
111100000000000
000000000000000
000000000000000
000000000000000
111000000000000
000000011100000
000000000000000
000000000111000
000000000000000
000000000000000
000000000000000
