000000000000000
000000000000000
000000000000000
000000000111000
000000000000000
000000011100000
111000000000000
001000000000000
000000000000000
000000100000000
000000100000000
000000100001111
111000110000000
001000000000000
000000000000000
000000001100000
000000001100000
000100000000000
000100000000000
000100000000000