000000000000000
000000000000000
000000010000000
000000000000000
000000000000000
000000000001110
111112000000000
000000000000000
000000000000000
000000000010000
000000000000000
000001110000000
000000000000000
000000000000000
010000000000000
000000000002110
000000000000000
000000010000000
000000000000000
000000000000000
