000000000000000
000000000000000
000000010000000
000000000000000
000000000000000
000000000001210
141115000000000
000000000000000
000000000000000
000000000010000
000000000000000
000001110000000
000000000000000
000000000000000
010000000000000
000000000003110
000000000000000
000000010000000
000000000000000
000000000000000
