000000011000000
000000010000000
000000010000000
000100000000000
000100000000001
000000000000000
000000000010000
000000000010000
111100000001000
100000000001000
100000000000000
000000000000000
000000000000000
000000000000111
000000000000000
000111000000000
000010000000000
000000000011000
000000000011000
000000000011000
