000000100100000
000000100000000
000000000000000
000000000000000
111000000000001
000000000000000
000000000000000
000000111111000
000000111111000
000000000000000
011000000000000
010000000000000
000000000011100
000000000000100
000000110000000
000000100000000
000000100000000
000000000000000
000000000000000
000000000000000
