000000000000000
000000010000000
000100000000000
000100000000000
000100000001000
000011100001000
000001000001000
000000000001110
000000000000000
000000100000000
000000100000000
000000101110001
000000001000000
000010000000000
000000000000000
000000000000000
000000000000000
000000000000000
000000000000000
000010001111000