000000000000000
000000000000000
000000000000100
000000001000000
000000001000000
000000001000000
111000000000000
000000000000000
000000000000000
000000000000000
000011111100000
000000111000000
000000101000000
000000101000000
000000101000010
000000000000000
000000000000000
000000000000000
000000000000000
000000000000000