000000001000000
000000000000000
000000000000000
000010000000000
000010000000000
000020000141111
000000000000000
000000000000000
000000000000000
020000240000000
000000000000000
000000000000000
000000000000000
000000000000000
000115000010000
000001000030000
000000000010000
000000000030000
000000000000000
000000000000000
