000000000000000
000000000000000
000000010000000
000000000000000
000000000000000
000000000001210
441115000000000
000000000000000
000000000000000
000000000010000
000000000000000
000002410000000
000000000000000
000000000000000
010000000000000
000000000003110
000000000000000
000000010000000
000000000000000
000000000000000
