000000000000000
000050000000000
000000000000000
000000010000000
000000000000000
000000000000040
000000000000000
000011111100000
000031111500000
000000000000000
000000000000000
000000000000000
121000000000000
000000000000000
000000004000000
000000001000000
000000001000000
000000000000400
000000000000000
000000000000000
